{
  "bg": ["tileset", "tomb"],
  "tiles": [
    "    .....    ",
    "    .....    ",
    "    .....    ",
    "      .      ",
    "      .      ",
    "      .      ",
    " ........... ",
    " .<.>.>.>.>. ",
    " ........... ",
    "             ",
    " ..... ..... ",
    " .>.>. .>.>. ",
    " ..... ..... ",
    "             ",
    " ..... ..... ",
    " .>.>. .>.>. ",
    " ..... ..... ",
    "             "
  ],
  "elems": [
    [[5, 1], "Soul", { "contents": "ClawRush" }],
    [[6, 1], "Soul", { "contents": "Virus" }],
    [[7, 1], "Soul", { "contents": "Roulette" }]
  ]
}
