[
  {
    "size": [7, 11],
    "tiles": [
      1, 0, 0, 0, 0, 0, 1,
      1, 0, 0, 0, 0, 0, 1,
      0, 0, 0, 0, 0, 0, 0,
      0, 0, 7, 8, 7, 0, 0,
      0, 0, 7, 7, 7, 0, 0,
      7, 7, 7, 7, 7, 7, 7,
      7, 7, 7, 7, 7, 7, 7,
      7, 7, 7, 7, 7, 7, 7,
      7, 7, 7, 7, 7, 7, 7,
      7, 7, 7, 7, 7, 7, 7,
      7, 7, 7, 7, 7, 7, 7
    ],
    "elems": [
      [[2, 2], "Column"],
      [[4, 2], "Column"]
    ],
    "items": true,
    "edges": [
      [3, -1]
    ],
    "doors": "TreasureDoor",
    "degree": 1,
    "hooks": {
      "on_place": "oasis.place"
    }
  },
  {
    "size": [8, 12],
    "tiles": [
      0, 0, 7, 7, 7, 7, 0, 0,
      0, 0, 7, 7, 7, 7, 0, 0,
      0, 7, 7, 7, 7, 7, 7, 0,
      7, 7, 7, 7, 7, 7, 7, 7,
      7, 7, 7, 7, 7, 7, 7, 7,
      0, 7, 7, 7, 7, 7, 7, 0,
      1, 0, 7, 7, 8, 7, 0, 1,
      1, 0, 0, 0, 0, 0, 0, 1,
      1, 0, 0, 0, 0, 0, 0, 1,
      1, 0, 0, 0, 0, 0, 0, 1,
      1, 1, 0, 0, 0, 0, 1, 1,
      1, 1, 0, 0, 0, 0, 1, 1
    ],
    "elems": [
      [[3, 7], "Column"],
      [[5, 7], "Column"]
    ],
    "items": true,
    "edges": [
      [4, 12]
    ],
    "doors": "TreasureDoor",
    "degree": 1,
    "hooks": {
      "on_place": "oasis.place"
    }
  }
]
