[
  {
    "size": [7, 11],
    "tiles": [
      1, 0, 0, 0, 0, 0, 1,
      1, 0, 0, 0, 0, 0, 1,
      0, 0, 0, 0, 0, 0, 0,
      0, 0, 6, 7, 6, 0, 0,
      0, 0, 6, 6, 6, 0, 0,
      6, 6, 6, 6, 6, 6, 6,
      6, 6, 6, 6, 6, 6, 6,
      6, 6, 6, 6, 6, 6, 6,
      6, 6, 6, 6, 6, 6, 6,
      6, 6, 6, 6, 6, 6, 6,
      6, 6, 6, 6, 6, 6, 6
    ],
    "elems": [
      [[2, 2], "Pillar"],
      [[4, 2], "Pillar"]
    ],
    "spawns_vases": true,
    "edges": [
      [3, -1]
    ],
    "doors": "TreasureDoor",
    "degree": 1,
    "hooks": {
      "on_place": "oasis.place"
    }
  },
  {
    "size": [8, 12],
    "tiles": [
      0, 0, 6, 6, 6, 6, 0, 0,
      0, 0, 6, 6, 6, 6, 0, 0,
      0, 6, 6, 6, 6, 6, 6, 0,
      6, 6, 6, 6, 6, 6, 6, 6,
      6, 6, 6, 6, 6, 6, 6, 6,
      0, 6, 6, 6, 6, 6, 6, 0,
      1, 0, 6, 6, 7, 6, 0, 1,
      1, 0, 0, 0, 0, 0, 0, 1,
      1, 0, 0, 0, 0, 0, 0, 1,
      1, 0, 0, 0, 0, 0, 0, 1,
      1, 1, 0, 0, 0, 0, 1, 1,
      1, 1, 0, 0, 0, 0, 1, 1
    ],
    "elems": [
      [[3, 7], "Pillar"],
      [[5, 7], "Pillar"]
    ],
    "spawns_vases": true,
    "edges": [
      [4, 12]
    ],
    "doors": "TreasureDoor",
    "degree": 1,
    "hooks": {
      "on_place": "oasis.place"
    }
  }
]
